####################################################################
####################################################################
####################################################################
### #    #       #   ####              ### #                   ##W##
###         #    * #H#### ############ #   ########## ########### ##
######*########*######### ############   ###########~*~######## ~*~#
#####            #   # ## #~Q~######## ###   #                    ##
############ ##                  ##### ##### #     #############~ ##
############ ###############  #  # ### ### # # # ################ ##
############ ################ #     ## ##  # # # ################ ##
######   *    * ## ##########*#####  # ### #%# *  ############### ##
######   ## # # ##    ## ###     ###    #  # # #  ############### ##
#######~ ## # # ## ##  # ####### ### ## #  # # #   ############## ##
######   ## # # ## ##    ###     ### #     * # ###   ############ ##
###### ~### # #  # ## ####### ######    #  # # *               ## ##
######   ##   #  # ##    ###  ##+  $ ####  # # #      ######## ## ##
######    #   #  # ##    ###  ###### #######   #### ####       ## ##
###### #### # #  # ## ## ### #######  #    # ###     G#  ####  *  ##
###### #### # ####  * #    *       #  #    #   # ###### ############
######  ### #      ## # #######  # #  #        #     ##        *  ##
######   #  #      ## #  ###### ## ## #  ##### ########### ##### ###
###    # *  # ########## ###     #           # ####I######  #### ###
### ######### ########## ###     ## ########## #### ####### ##   ###
### ###### #  ########## ###### ### #   ###### ####  ###### ##*#####
### #####  #  #########  ###     ## #   ####         ###### ##    ##
### ###### #   #########  ## #   ## ###      #    ## ###### ##### ##
### ###~## #    # ~B~#### #########     #### # #  #  ###### ##    ##
###    %   *    # #  # #  ###  ############# # # ########## ## #####
### ###~###### ## ## # #  ####  ###########  # ############ ##   ###
### ######        #  #    ####   #########   # ############ *    ###
### #####C #    # # ## #  ####       ####      # ########## ## # ###
### ###### # ## # #    #########*### #### ######     ###### ## # ###
### ###### #    # #  #           ### ####     ## ### ###### ## # ###
### ######      #    ######$#    ##  #####  #  # # # ###### ## # ###
### ########## ############ #### #   ##### ### # # # ###### ## # ###
### ##     #   ############ ####           ###     #  #     ## # ###
### ## ###   # ############ #### # ######   #####  #    ###### # ###
### ## ### # #   #########  #### ######### #######*#### ###### # ###
### ## ### # #########D### #####               #        ###### # ###
###    ### #     ##### ### ######*############ # ### ######### # ###
### ## ######## ## ##  $   ##      ########### # ### ~######## # ###
### #   * ####   #     #####  # #~~~########## # ### *            ##
### #   # ####   # ##  ###### # #~+~########## ~ ### ~########### ##
### #   #    ### # ##    A##  # #~ ~########## % #   ####   ##### ##
### #   # ####J# # ##  # #### # #~ ~########## $ # # ####   ##### ##
### #####  #        #         # #~     ##    # # # #  ### ####    ##
###   #          # ###################    #    #                  ##
####################################################################
####################################################################
