####################################################################
####################################################################
####################################################################
####         ##############                    # ###########      ##
#### #########           #  ################## #           # ## # ##
#### ##        # # ### # # ##                # # ######### # #  # ##
#### ## #~*~## # # # # # # #### ############ # # #       # # #  # ##
#### ## ##B# # # # # # # # #               # # # # ##### # # # ## ##
#### ## #### # # # # # # # ################# # # # #   # # # #  # ##
####  # #    # # # # # # # *  #   #   #      #$# # # #G# # # ## # ##
##### * # ## # # # # # #   # # # # # # # #  ## # # # ### # #    # ##
####  # # ## #            #               # ## # # #     # # #  # ##
##### # # ## ############### #H# # # # # #  ## # # ####### # ## # ##
##### # # ##   *              #   #   #     ## # #         # ## # ##
##### # # #### ####### ######   #   #   # #### # ######### # ## # ##
##### # # #### #######*#####~*~############### #           # #  # ##
##### # # ####                                 # ########### #  # ##
##### # # #### #### ######## ############## #  #          *  # ## ##
##### # # #### #               ############ ############### ## ## ##
##### # # #### # ############# ############ *               ## ## ##
###   # #      # ############# ############################ ##  # ##
### # #*########*#############*################     ####### ### # ##
### # #                               ######### ~*~ ####### *   # ##
### #*# ############################# ######### # # ####### # # # ##
###                              ####           #D#         #*### ##
########### ######### ##### ####*############## ### ##### #       ##
###       # #       # ##### #         #       #     # # # ##### # ##
### ##### # ######### #J### ## ######## # ### ####### # #     # # ##
###     # # ##      # # ### ## X#       # # # # # ##    ##### # # ##
####### # # #   ### # #   # ##### ####### #          #   ## # # # ##
####  # # # # ###W# # ### #               ### ## ## ## #    # # #$##
###   # # # # *   # # ### # ###############          # # ## # # # ##
### ### # # # ##### # ### # ########################## # #  # # # ##
###     # # #       # ###*#*#####        #####         # # ## ### ##
######### # ####### # ###    #### ###### ##### # ####### # ## ##  ##
####      #       ~*~ ###  #      ######   $   # #       # #   #  ##
#########   #####          # #######   ####### # #  ######## ### ###
###########~######*#######*# ##   ## #       # # # ###           ###
#######         ## ###       ## #    #    #  # # #  ## ##### # # ###
####### ###~### ## ### ##### ##  #  ###  #  ## # # ### #     # # ###
####### #     # ## ###     # ###  # ~A~ #  #   #    ## # ~## # # ###
####### # ### #    ##### ### ####  #   #  #  ###### ## #  Q# # # ###
####### #  ## # ######## #      # #  #  # #     ##  ## # ~## # # ###
#######  # C# # ######## # ###### # ### # #####  ## #  #     # # ###
########  ### # ######## # #      # ### #     ## #  #  ##### # # ###
#########     # ######## # ######## ### ##### ## ####          #  ##
##############           #           #        ##      ###### #### ##
####################################################################
####################################################################
