####################################################################
####################################################################
####################################################################
###   #####################  ##### #   *               ~##        ##
###*##########         * ##~ #     ## ## ####~*~#### #~    ~ ~ ~ ~##
###   ################## ##  #     #   #               ~##        ##
####   ######            #~ ~# #~####~###~###~*~######~    ~ ~ ~ ~##
#####   ####             ##  #    #   *                ~##        ##
######   ~~    #####~###  *  *    *   #  ####~*~###  ##  # ~ ~ ~ ~##
#######      ###~###W  * ##%########  #             #### #        ##
########   ~#      ~#######      #### * #*# #~*~#  ##### # ~ ~ ~ ~##
### # ###  $       /###   #       n#####~ #       ###### #        ##
### #  ##  ~#      ~#     #      #### #   ####  ####~###*# ~ ~ #*###
### ~  ~#    ~    ##H     ####~$~#  #   ~  #   #  ##  *   ~ ~ ~# ###
###    ~####~~#~$#~##~###          ### ### # #  #  #####       * ###
###    *     *     ##  *  #######  * C#B *   ##  # # ##  ####### ###
### ~  ########  ###  ###   *      ### ### # ### * # ##*##   #   ###
###    ~#     ##  a  ####~~##       #   ~  # ##  # #  # ##*#########
###    ##  #################### ##    #    # #  #  ##*#  #        ##
###o#p###b##################### #######~###    #  ##  ## ##*##~*####
########  ##################### ## #    I### #  #### ### ##       ##
#######    ~~################## #    ####  * ## ###  ###*##*~~*~~ ##
######      ~#~~~~~~~~######### ## #     ~## ## ##    ## #  ~   * ##
######~~%~~##################G# #  ###~~%~  # # #   #  #    *   ~*##
#### ~     ######## # # #   # # *     ~  * ## * * # ##   #~ ~~*~~ ##
###  *        *   *       #   # #####~~  ~    # ### ### ###       ##
###*~#     ######### ~ # #   ##*####~~  #####~#*#~#~~#####~#########
###  ###~##########     #  #  # *  #   ##     ~ ~    # #     ~   ###
####  #  #  #  #    ~ ~ ##### * #      *   ~    ~   #    ###   #  ##
#####   ~         #     #  #  # ##  #####  ~  ~    #  ~ #    ##   ##
#####~    #######X## ~ ~ #   ## #  ##~J~##  ~    ~        #      ###
#####  ~~  ### ####       #   # #  #     #    ~  #####~#####~##   ##
#####  #  ###   ##  # # #   #      #     ###  ####  *         # # ##
########   #  ~  ###################     ###  ####  #~~~#   ~~#   ##
###     ## ##   #     #       *  * #*~~~*#       ##     #   #  #  ##
###  ~ ~   ###%#       ##~##*~######     ####~~# ###~##*##  ##   ###
####  ~    *   *   ~                  ~          ###### ##   #  # ##
#### ~~ ~ ~~~#%#       ~####*###~###     ##~#~## ###### ##~  ##   ##
#### ~~~   ~~   #     ~~~~~     * :#*~~~*# ##### ###### ###~  %   ##
###  ~~    ~  ~  ###################     #       ###### #####*######
### ~~~~~ ~~~   ##      #      *   #     #*~$~#########*####   #####
###  ~     ~## ###      #  ~~###   #     # #  ######### ###   # ####
### ~~~ ~~~########~##  #  ~   *   ##~A~## #          * ##       ###
###  ~  ~  ###########  ~  #   ########### ##############   ~  #  ##
### ~~~ ~  ###~~~~~~~~  #  ~               #      ~               ##
###  ~  ~    $       $     #~######~##~##### ~      ~    ~   #    ##
####    ######~~~~~~~#######                    ~          #      ##
####################################################################
####################################################################
