####################################################################
####################################################################
####################################################################
##### # ##       #      # # #                  #    #####    #    ##
####     #  #  ### ## # #   #                     #   #   #  #### ##
###  # #   #  #### ## #  ##     # # ############ ##       ##    # ##
### ##### #  #   ###A # #   # ##   ##              #  #  #    # # ##
###  # #   #  # #   # #   # # #     # ##~ ####  #     #     # # # ##
###      #  #      ##$## ## ##Q## ###        ## #  # ### #  #     ##
###### ########### $X $  #   # #   ## ##  ~~  #### ####### ##### ###
####   ###   # ### ##$##   #     #    ###  ~~   #  #I### #  #     ##
#### ####  #    #   # #  #   # #   #  ####  ~~  #     #     # ######
###  ###  ##  #   #     ### ## ## ### #####  ~~    #  #  #        ##
### ###  ### ######### ##     #       ######  ~~ ##       ### ### ##
### #      #  # # # #   #   # # #############     #   #   ##   ## ##
###   ####  #         #     #   #G          ####    ##### #  #  # ##
#####      #  # # # #   #   # # ##   ~~~      ##~ #         ###   ##
#######  ~~# ######### ##   # #      ~~~   ## #   #   #### ##### ###
#######        #####          ###           #B#  ~   #####  ###   ##
#########~~~~~############  #   ###~## ########  ~ ~  ### #  #  # ##
###                  ##### ~~#       # # # #    ## ##  #  ##   ## ##
##### ####~~~~###$~  ####~ ~########## #     ####D#       ### ### ##
###   ########### ~  ####~  ~  ~ #     # #  # ##    # ####~~~~######
### #############*~~  ###  ~ ~   # ~ ~ # # #   # #~ ##       ~~#####
### #   *    *     ~  ##~  ~ # ~ # # # # #    ###    # #####   #####
###*################*~###  ~ ~ # ~ # ~ # ###~ ~  #~ ## #   ### #####
### *              *      ~~   #   #   #      *        # ~   ~ #####
###*#######~~#~#####*####  ~##################~*~#######*####~ #####
###                  #  #                             *  #   ~ #####
########### ##########  #####################~*~#####*#### ~ ~ #####
###       #       #### $       #    *                    * ~*~ #####
##### # ###   ~ ~######  ##   #  ##################*########   #####
###   #   ##~ ~   ##~~  ###  #  ######  * *  ###           #~*~#####
#### ### ##       ##~  ####  # ####### ##*## ### ###########~ ~## ##
###   #   ####~#  #~  ~#### ## #####   #   #  ## #                ##
##### #           #  ~ #### D# #####*##  ~  #### # ### ~ ~  ~###~*##
####  ############# $   ###### ###   #  ###  ### # #~  #J#  *   * ##
#### #             ~~~~    *        ~  ~###~ C## # ### ###  ~   #*##
###    ###   ### ##   ## ##### ~#####~  ###  ### #        #### #~ ##
###    # #   # #  # # ~   #### *      ~  ~  #### ~        #### #####
##### ##   #   #  # # ### #### ##~##   #   ##### # ### ~##  ## ## ##
#####  ##     ##  # # ~   #### ## ###*### ###### # #~#   #  ~   ~*##
######*##$####### # # # ~~~######*#    #   ##### # # # ~##  *   * ##
###    ## # #~~     # ~   $   *   #   #  #  #### #          ~####*##
###*### *   #H  ~   # ### ~####~~*#  #  ###  ### #  #  ##       # ##
###   # # # #~~~~ # #     ~#   *  # #  #####  ##   ######### # ## ##
###W# * # #       # # ##############  #######  #  #####      #    ##
####################################################################
####################################################################
