####################################################################
##############################      #    ###########################
############################## #### # ##     #######################
### #    #       #   ####              ### #                   ##B##
###         #    * #A#### ############ #   ########## ########### ##
######*########*######### ############   ###########~*~######## ~*~#
#####            #   # ## #~C~######## ###   #                    ##
############ ##                  ##### ##### #     #############~ ##
############ ###############  #  # ### ### # # # #####       #### ##
############ ################ #     ## ##  # # # ##### ##### #### ##
######   *    * ## ##########*#####  # ### #%# *  ####     # #### ##
######   ## # # ##    ## ###     ###    #  # # #  ######## # #### ##
#######~ ## # # ## ##  # ####### ### ## #  # # #   ####### #u#### ##
######   ## # # ## ##    ###     ### #     * # ###   ####~ ~##### ##
###### ~### # #  # ## ####### ######    #  # # *               ## ##
######   ##   #  # ##    ###  ##+  $ ####  # # #      ######## ## ##
######    #   #  # ##    ###  ###### #######   #### ####       ## ##
###### #### # #  # ## ## ### #######  #    # ###     D#  ####  *  ##
###### #### # ####  * #    *       #  #    #   # ###### ############
######  ### #      ## # #######  # #  #        #     ##        *  ##
######   #  #      ## #  ###### ## ## #  ##### ########### ##### ###
###    # *  # ########## ###     #           # ####G######  #### ###
### ######### ########## ###     ## ########## #### ####### ##   ###
### ###### #  ########## ###### ### #   ###### ####  ###### ##*#####
### #####  #  #########  ###     ## #   ####         ###### ##    ##
### ###### #   #########  ## #   ## ###      #    ## ###### ##### ##
### ###~## #    # ~H~#### #########     #### # #  #  ###### ##    ##
###    %   *    # #  # #  ###  ############# # # ########## ## #####
### ###~###### ## ## # #  ####               # ############ ##   ###
### ######        #  #    ####   ##### ###   # ############ *    ###
### #####J #    # # ## #  $  $       # ##      # ########## ## # ###
### ###### # ## # #    #########*### # ## ######     ###### ## # ###
### ###### #    # #  #           ### # ##     ## ### ###### ## # ###
### ######      #    ######$#    ##  # ###  #  # # # ###### ## # ###
### ########## ############ #### #   # ### ### # # # ###### ## # ###
### ##     #   ############ ####           ###     #  #     ## # ###
### ## ###   # ############ #### # ######   #####  #    ###### # ###
### ## ### # #   #########  #### ######### #######*#### ###### # ###
### ## ### # ######### ### #####               #        ###### # ###
###    ### #     ##### ### ######*############ # ### ######### # ###
### ##*######## ## ##  $   ##      ########### # ### ~######## # ###
### #   * ####   #     #####  # #~~~########## # ### *            ##
###i#   # ####   # ##  ###### # #~+~########## ~ ### ~########### ##
### ### #    ### # ##      #  # #~ ~########## % #   ####W####### ##
###  v#v# ####Q# # ##  # #### # #~ ~########## $ # # ####  u##### ##
### #####  #        #         # #~     ##    # # # #  ###h####    ##
### X##          # ###################    #    #                  ##
####################################################################
####################################################################
