####################################################################
####################################################################
####################################################################
###                 ## ###### ##A####### #####       #            ##
### ### ### ### ### #   #K# %                  ##### ####### #######
### #J# # #%# # # # # # # # # ##### ## # #####     #       # #   G##
### # # # # # # # # # #   # # ##### ## # ##### # # # ##### # # # ###
### # # # # # # # # # ##### # ##### ## # ##### #   # #   # # # # ###
### # # # # # # # #             ###      #     # # # # # # # # # ###
### # ### # # ### # ####### ### ###### ### ### #     # # # #   # ###
###   #             ####### ### ###### ### ### ##### # # # ##### ###
##### # ####### ########### ###   #### ### ###         #          ##
###x# # #######          ## #####        # ###### #### #### ########
### # # ######~ ~######~ ~# ##H#### # ## # ###### #### #### #     ##
### # # ######~ $      $ ~# ## #### # ## # ####}$ #### #### # ### ##
### # # ###     ~######~ ~#      ##   ## #   #### #### #### # E## ##
###     ### #################### ######  ### #### #### #### # ### ##
### ### ### ###### # # # # # # #  #####   ## #### ##      # #     ##
###     ### #### # # # # # # # # ###### # ## ###~ ~# #### # # # # ##
### ### ### ###  #         %        ### # ## #### ## #### # # # # ##
###     ### ##      ### #########  #### # ## #### ## #### # # # # ##
### ### ### ####   #### ##########   ## # ##      ##      # # # # ##
###     ### ####  ####~ ~####   ##    # # ####### ## ####   #     ##
### ### ### #### #####~ ~####   #### ## # ### ###    ###### # # # ##
###     ### ###  #####~ ~##     ####  # #   $  ## ######### # # # ##
####### ### ##   ###### ### ###B#### ## ### ##  # #         # # # ##
####### ### #### ###### ###$########  # ### #  ## # ### ## ## # # ##
####### ### ##   ######      ####### ## ### ##  # # ### ##    # # ##
###         ###   ###C#$#### ######   # ### ### $ # ###   ##### # ##
### ### # ######  ###   ###~ ~##### ### $ $ ##### #     #       # ##
### ### # ###     ###   ###~ ~#####   # ###       # ############# ##
### ### # ######  #########~ ~##### ### ### ####### ##            ##
### ### # #######          # ######   # ### #       ## ## ##########
### ### # ######  ####k###          ### ### # # # # ##  #     ######
###       #       #### ##### ###### # # ### # # # ##j## # ### ######
### ### ### ####  ###x ##W#~ ~####    # ### # # # ## ## # ### #   ##
### ### ### #####  ###    #~ ~####  # # ### # # # ## ## # #     # ##
### ###     ######  ######## ####   ### ### # # # ## ##     # ### ##
### #   #####                     #   # ###        #  # ## ## ### ##
### # #       #   # #   # #   # #   # # ##### # #  # ## ## ## ### ##
### # #### ## ##### ##### ##### ##### # ##### # #    ## ## ##     ##
### # #### ## #####%# # # # # # ##### # ##### # # #  ## ##### ### ##
###           ##D## # # # # # # ## ## #    ## # # ## ## ##w## ### ##
############# ## ## # # # # # # ## ## ####$## # # #  ## #X  j ### ##
###                       #           #### ## # # # ### ##### ### ##
### ########### # # ####  ####  # # # ####}## #                   ##
###     %  #### # # #           # # ######### ##### ###### #### ####
####################################################################
####################################################################
