####################################################################
####################################################################
####################################################################
####                   ############### l     ##########         ####
#### ####### ######### ############### #   #          # ####### ####
#### #C   *          #    ##       ### ### ########## # ##### # ####
#### ########$###### # ## ## ##### ###   # ###     ## # ##### # ####
#### #        ###    # ##    #   # ##### #*## # # # # # ##### # ####
#### # ### ## ### # ## #  #### # # ##  # # #  # # #   #  *    # ####
###    ### ##   ### ##   ##    # # ### # # # ## # ### ######### ####
### ###### ## ###   ## # ###  ##       # #      *        *      ####
###*### ##*## #Q### ## ##### ###D# ### # ##   ###### ######## ######
###     ## ## * #   ##       ##### # # #  # #        ##     # ######
### ### ## ## ############## ##  ### # ## # #%###### ## #*# # ######
###  y# ## ##        ####### # ###      # # #  #  #   # # # # ######
### ###    #########      ## # # ###### # # #  #    # # # # #     ##
### #B  #####        ####  * #   ##>  $   # #  #### # # # #   ######
### ### #####*######   ## #### ######## # # ##      #   #  #   * J##
###*### ##           ####         *     # #   #######  #    #  #####
### ###    ########### ## ###### ###### # ###         #   #  #   ###
### ### ####    #      #  #### # #    ###   ###*###  #   #W#  ## ###
### #     ## ## # ## ### ###   #*# ##     #   #  G## #  #~ ~#  #  ##
### # ### ## ## #*## ### ##  ### # #### ### # ###### # #~   ~# ## ##
###*# ##   * ##   ## ### ## ####   ##E#   ### ###### # #~ % ~# ## ##
### # ## ######## ##     ## #    #### # ###   ######## #~   ~# ## ##
### # ## ######## ######### # #######*# # ### ####   # #~   ~# #####
### #          ## ###    #    #   ### #   #      ###   #~   ~#   ###
### # ## ##### ## ### ## ####         # ###### #   # #####*##### ###
### # ## ##### ##      #   ## #####   #      ### # # # #y# # #   ###
### # ## ##### ####$## # # #    ####$#######   ### # #   # #   #####
###*#     * *        #   #   #  #### #>  ### ###   # ### # # #######
### ####### ## ####### # # ### ##### ### ### # ### #   # # # #   H##
###       # ## ##        #   # #     ### ###   #   ##### # # #*#####
### ##### # ## ## ###   ###    # #######$### ##### ##### # # # #####
### ##### # ## ## #   # * * #### # #  ##       %   ##### # # # #####
###*#     # ## ## # #  ##X# # ## # #       #   ######### #*# # #####
### # ##### ## ## # #    #    ## # ### # # #          ##     # #####
### #    ## ## ## # ## # # ## ##   %     # #### ##### ## ##### #####
### # ## ## ## ## # #       # ## # ## ## #      ##### ## #     #####
### #      %*  ## #   # #*# # #  # #   # # #### ###   ## # ### #####
### ####### # ### ### # # *   ##   ##  #   #     ## #### # ### #####
###       # # ###     ### ########### ### ### ## ## #### #     #####
### # ### # # #######    ###### ################  * #### # ### #####
### # ### #        ## ##                         ## #### #     #####
### #     # ###### ## # ############*############## ####*#*#########
### # ##    $   ## ##                                l     #########
###A# ## ######       ##############################################
####################################################################
####################################################################
