####################################################################
####################################################################
####################################################################
#### ~###                              *    #      # *       #    ##
###   X#    #####  ###########*##########        ###m#  #    #    ##
#### ~###  ##      #         # #      * #   ###    ########       ##
#### # #    #     ########## # ########   ###   ####   # #   #    ##
####z# ## ####### #+ #    ## # #    * #     #          #     ## ####
#### #     # *    #      # # # ###### #   ###########  #  #  #    ##
####   #   # #### # # %~   # # #  * #     #    # #= ##   ######## ##
#####*###### #  # ##       # # ####     # #      ##$# #  ###      ##
###          #    # % # ~%~#*###  #  # #######   #  #  # ### #### ##
#########*#### #### ~      #      #  #  #   #       ##  #### #    ##
###          # #  ########*# ####   ### ##  #  #    #    ###### ####
###    ## ## # #                #    #  #      ###  ## #     #    ##
### #  #  #  #      #     #     ########## #   # *  #  ##### ## ####
###/## ######### ###### # #  #### # #   #  # ######### #     #    ##
#####  #    #  # #   #  ####  ### #   # #         # #  # # # ## # ##
###    #    ##*# #   *  # *   ##    ###### ##  #  #    ##### #  # ##
###########      ######## # #### # ##  #   #   #  ###### #      # ##
###              #  #     # #    #  ##*##  #  #####  #   ###  #*#*##
### #     # # #  #  ###   ###### ##       ##    # #  #   # ## #   ##
### ##### # # #         # #      #  ###      #       # #   #  #   ##
### #   # # # ### #####*########*######*########    #####  # ##*#*##
### #   * # # #    ####  ###   # ####    ##### ####  #  #    #    ##
######### # # #    #     ### # # ##### # ##~ # #        ###  #    ##
####      # # #    ##### #   # #  # #  # ##~ # #  # #   #    *    ##
####   #  # # ## # # #   # #    # #      #     # ##*##    ##########
####   #  # # #  # #   #   ##   ~ ~  # #   ### #  # #  ####  #    ##
###    #  # # #  # # # # ##### ##J## ###~#  #  # ##*## #  *  *    ##
###*####### # #  # * ###   Q##  ###  ##H   ### *  # #  #  ####### ##
### #     # # # #### ### #####  ###  ###~#     #       *  *     # ##
### #     ~%~%~    #####   ###  ########   ### ############## ### ##
### #     # # ######            ###   #  ##### ############## #   ##
### #####*# # #    *   ~ ~  ## ##C### # ###### *            # ###*##
###       # # # #  # # #E#  ##  ~ ~B# # ###### ############ # #   ##
####*##   # # # ## # #D#### ##  # # # # ###### #   #+  * #  # #   ##
###   ### # # # #  # ## #         # #   ###### #   ##### #  #*###*##
###   #   # # ###### #  ###### #  # ## ####    ### # # # #    #   ##
####*## ### # #    #           ##      #### ####         # ###### ##
###   # # # # #    #    # ~ ~# #  ~ ~     # ####   # # # #  #   * ##
###   * # # # #    * ## # # ## #  #A##### ############ # #  ##### ##
###   # # # # #### # #  # #### #  ###     ###### #  #  #    #   * ##
#######   # # #    ####*########*######*########    #  # ######## ##
###  #    #     #     #             ##     #  #     #### #      * ##
###  $    #### ###   ## ##### #     #    #       #     * # ###### ##
###/*# #     *  #  #  # #   ##### #### # #### ##### #### # #m   * ##
####################################################################
####################################################################
