####################################################################
####################################################################
####################################################################
######################## #     ##     ######################  ###X##
###     #      #     # #### #  #####  ######################   ## ##
#### ## #      #  #      ##### ##    ####################### #  #*##
###A ## ## ## ## ## ## #        #       # #      #     # ###      ##
#### ## ## ## ## ## ## ###    #   ####  # #      #  #        # # ###
####        #          # ## #####   #   # ## ## ##*## ## #   # #  ##
#### ##   # ##  # # ##   ## # # #  ## # # ## ## ## ## ## ### # #####
#### ## #### #### #### # ## # # # #####       #          # # #    ##
####     #   #  # #    #*#    #   ##    #   # ##  # # ##   # # # ###
#### ##             ## #      #   ####  # #### #### #### # #      ##
###  ## ## ## ## ## ## # #### # #### ##    #   #  # #    # ### # ###
### ### ## ## ## ## ## # *    # *    #  #           * ## #     # ###
### ###### ## ## ##    # #  # # ## # #### ## ## ## ## ## # #########
### ###### ## ## ### #   ## # # ## #   C# ## ## ## ## ## #        ##
### ###### ## ## ### ###### # # ## #  ##   #  # ## ##    # ###### ##
### ###          ###     ## # ###  ##   #  ## #    #####   #    # ##
### ### #### ########### ##        #### #   # #### ######### ## # ##
### ### #### ###########*#######*###### ### #    # #####G     # # ##
###     ####B###########     ### *   ## ### #### # ########## #   ##
######################## ### ### ### ## ###    # # ########## #   ##
###                   ## #   ### # * #  ###### # # ####       # # ##
### ##### ###### #### ## # # ### #Q# # ####### # # #### ##### # # ##
### ##### ###### #### #      ### #####   ##### # # #### ##### # # ##
### ##### ##     #### # ######## # # #  ####   # # #### ##### # # ##
### ##H## ## ###      # # ###### # # # ##### ### # #### ####  #   ##
###       ## ######## #   ######   #   ##    ##  # #### #### ## # ##
### ##### ## ######## #   #######  #  #####  #  ## #### ####      ##
### ##### ## #        # # ######## # #### ## # ### ####*#######   ##
### #####      ###### ##  ###      #      #     #             # # ##
### ###   ### ####### #  ###  #  # # ## # ##### ## ########## # # ##
### ### ##### ####### # #### ### # # ## #           #   #     # # ##
### ### ##### ####### # # #   #  #   ## #  ######## # ### ##### # ##
###                   #   # #### ######         # # # *   ####  # ##
### ### #### #### ### # # #           # #J####  # #   ### #    #  ##
### ### #### ####     # # ##### # ### ######### # # #   # # #### ###
###          #### ### #####   # #   # #           # ### # #      ###
### ##### ## #### ### #   ##  # ### #   ########### ### # ## ###  ##
### ##### ## #### ### #       #   # # #           # ### #      # ###
###   ###           # # ### ##### #   # #### ###################  ##
### # ###### ######   #   #   #   # # # #                      ## ##
### #    ### ###### # ### # # # # # # # ###################### #  ##
### ####     ###W## # #   # #   # #   #                     D# # ###
### #### ####### ## # ######################################## #  ##
###                   *         *         *            *       ## ##
####################################################################
####################################################################
