####################################################################
####################################################################
####################################################################
###                 ##########################                    ##
### ### ### ### ### #     #                  * # # # # # # # # # ###
### # # # # # # # # $     $ ##################                   H##
### # # # # # # # # #     # ################## # # # # # # # # # ###
### # # # # # # # # ####### ##################                    ##
### # #D# # # #G# #      *      ##########   * # # # # # # # # # ###
### # ### # # ### # ####### ### ########## ###                    ##
###     *   *       ####### ### ########## ### # # # # # # # # # ###
### ### ####### ########### ###   ######## ###                    ##
### ### #######     *    ## #####     *  # ######*####*####*########
### ### ####### ######## ##*############ # ###### #### #### #  *  ##
### ### ####### #      # ## ############ # ####C* #### #### # ### ##
### ### ###  *  #      # ##      ####### #   #### #### #### # ### ##
###     ### ############$####### ######  ### #### #### #### # ### ##
### ### ### ###### # # # # # # #  #####   ## #### ##      # #  *  ##
### ### ### #### # # # # # # # # ######*# ## #### ## #### # # ### ##
### ### ### ###  #                  ### # ## #### ## #### # # ### ##
###%### ### ##      #############  #### # ## #### ## #### # # ### ##
### ### ### ####   #             #   ## # ##      ## #### # # ### ##
### ### ### ####     ###########      # # ####### ## ####   # ### ##
### ### ### #### # ############### # ## # ###   #    ###### # ### ##
###     ### ###  # #             # #  #%#   #   # ######### # ### ##
####### ### ##   # # ########### # # ## ### ##### #         # ### ##
####### ### #### # # #         # # #  # ### $ B## # ###### ## ### ##
####### ### ##   # # # ### ### # # # ## ### ##### # ######    ### ##
#######     ###        * # # *        # ### #   # # ############# ##
####### ## #####  # #### # # #### # ### $   ##### # ############# ##
####### ## ##J *         #*#          # ###       # ############# ##
####### ## #####  # # ~       ~ # # ### ### ####### ##            ##
###     ## ###### # # ######### # #   # ### #       ## #############
### ### ## #####  # #           # # ### ### # ##### ##  ############
### ### ## ##  *  # ############# # # # ### # ###### ## ############
### ### ## #####      #########     * # ### # ###### ## #######   ##
### ### ## ######  #             #  #Q# ### # ###### ## ###     #*##
###     ## #######  #############   ### ###*# ###### ##     #*### ##
### ### ## ##                     #   # $          #  #*##### ### ##
### ###       #   # ~   ~ ~   ~ #   # # ##### # #  # ## ##### ### ##
### ######### ##$## ##### ##### ##$## # ##### # ##   ## ##### ### ##
### ######### #   # ##### ##### #   # #$##### # ###  ## ##### ### ##
### ######### #   # #####%##### #   # #    ## # #### ## ##### ### ##
###           $   $ ##### ##### $   $ #### ## # ###  ## ##### ### ##
############# ##X## ##### ##### ##A## #### ## #*### ###*#####*### ##
############# ##### ##### ##### ##### #### ## #                 * ##
#############                         #       ##### ###### #### #W##
####################################################################
####################################################################
