####################################################################
####################################################################
####################################################################
###W~ #                         #       *  ###       ## ##~#########
###   # ######  # ## #  ####### # # #  ###     #####    ##+ ########
####~   #  # ## # ##### #     # # # #  #### ########## ###~ ########
###   #      #  # ##### # # # # # ~ ##  ##   #########  ##   #### ##
####### #########    ## # # # # # #%    #     ###                 ##
###     #    #     # ##   # # # # ###~# # ### ### ####### ####### ##
####### ###  ####### ###### # # #       # ### ### ###   # ###   # ##
###                       # # #*### ### # ###  ## ###     ###     ##
########$################ # # #  ## # # # ###     ##### # ##### # ##
###  ### #    ####      #     # #   # # # ###   # ###     ###     ##
#### ### ###  ###  #  # #######   # ~%~ # ####### ###   # ###   # ##
####        #     ## ## #       #   # # # ####### ####### ####### ##
#### ### ##  #  ####### ######### # # # #                         ##
###  ##  # #  #     ##  ######### # # # ##############*#######*#####
#### ##     #   ##   #  #B#####C#  ## #              # # # # # # ###
###  ## # #  #  #  #   ##*#####*##  #   #######   #  # #          ##
####    # #   #   #   ##~ ~##~  ~##  ############ #  # # # # # # ###
###   # ####    #  # #### ####  ####            * ##   #          ##
#### ## # #  #  # ###~ #           ~###*# ##### # #  ### # # # # ###
###   # #    # ## ##I*    ~#####~  *D## # ##### ####   #          ##
#### ##### ### ## ###~    *J###A*  ~### # ##### #####  # # # # # ###
###               ##H* #  ~#####~  *G## #  ###  # # ## #          ##
#####*######*########~###         ~#### ##  #  ## #  # # # # # # ###
##### # #### ####    ############ ##### ###   ###   #  #          ##
###        # #### ####### *       ##### ###~*~#####    ########*####
### ######## ####      ## ############# ###   ###   #   *  # ## ####
### #   * ## #    ####### #             * #   ###   #   #  # ## ####
### #####  ~ ~### ####### ############### #   #####    ##  #    ####
### ###### #n#### #           ## a      # #~*~###   # ##   #### ####
###      * ###### # #### ##    ~ ~  # ### #   ### #  ##       # ####
########## ######*# #### #####   #### ### #   ### # ##  ###     ####
###     *         # #### ##### #####    # #   #######     ## #######
#######*########### ####    ## ##### #### #~*~########### #  *    ##
### * #    # ###         ## ## ##### #### #   #### ##   # #  #### ##
### # # #### ### ## #### ## ## #####   ## #   ###   ###   ##    # ##
### # # #### * #  # #### ##    ######  ## #   ### # #   # #     # ##
### # # #### # # ##################### ## #~*~### # # ######### # ##
### # #      # #    #######         ## ## #   ### #   #        ## ##
### # ######## # ##*#     # # # # # ## ## #   ### # ##  ######  # ##
### # #        # ## #### ##       # ## ## #   ### # #  ########   ##
### # # ###### *  # #### ## # # # # ## ## #~*~### # # #       ##  ##
### # # ######### # ####  #       # ##    #   ####### # #####  ~# ##
###*### ######### # ##### # ####### ## ###  #  #####~ ~ #####  +~ ~#
###        ####   * *     $ #######        ###  ##### * ##### #~#X##
####################################################################
####################################################################
