####################################################################
####################################################################
####################################################################
###X   ##### ###                                           #########
###### ##### #H# # # ####### ######## ########### ######## #########
###### ##### #*# # # ####### ######## ########### ######## #########
###### #####     # #                                              ##
######       ##### #### ######## ######### ######## ############# ##
######## #########                                    ########### ##
####     ############################################ ###########*##
#### #*# ###### # # # # #############################*#         # ##
#### #G# ## o##         #############################C# # # #o# # ##
#### ### ## # # # # # #                             ###     ##### ##
####     ##             ######## ############# #### # # # # # # # ##
######## #### # # # # # ######## #/       ####*####             # ##
########  ###           ######## ######## ###   ### # # # # # ### ##
######### ####*################# ########$##  #  ########*####### ##
#########              #########D######## ## ### ##             * ##
########## ### ####### ##      ###    ### ## ### ## ##### ####### ##
##########   #%##    # ## ########### ### ## ### ## $  ##%#  #### ##
############ # ## ## # ## #         # ### ## ### ## #  ## $  #### ##
############ # ## ## # ## # ####### # ### ## ### ## #  ## #  #### ##
############ # ## ## # ## # #     # b ### ## ### ## #  ## #  #### ##
############ # ## ## # ## # # ### # # ### ## ### ## ## ## ## ####*##
###   ###### # ## ## # ## # # #W# # # ### ## ### ## ## ## ## ##   ##
###*#             ## # ## #       # # ### ## ### ## ## ## ## ## ####
###J# #### ######### # ## ## ###### # ### ## ### ## ## ## ## ## *J##
##### #### ######### # ## #o        # ### ## ### ## ## ## ## ## ####
###   #### ######### # ## ########### ### ## ### ## ##  # ##  #   ##
#######              # ##             ### ##  #  ## ##  # ##  # # ##
################## # # ## ##########*####$##     ## ##  $ ##  $ # ##
########         # # # ## ########## ####  ##   ### ##### ##### # ##
#########  ####  # # #    ########## ####   ##*## *               ##
##########  ### ## # ###########I### #### # #     ##### ###### #####
####### ###  ##    #           #*###             ##          #    ##
######   ###*################# # ### #### # # # ### # ###### #######
#####  #  ##       #           *        #       ### #      #      ##
####  # #  ### ### # ######### # ###### # # # # ### ###### # #### ##
###  #   #  ## #A# # ######### #  ##### #       ###      # #   ## ##
### #  #  #    #*# # ######### ## ##### # # # # ######## # ##   # ##
###   # #   ##     # ######### ## ##### #       ##     # #    #   ##
##### #  ########### ######### ## #Q  * ########## # # # ###### # ##
### # ## #              ###### ## ################ #B# #        # ##
###      # #####$###### ###### ##         ######## ### ###### ### ##
### # # ## ##### ###### ###### ##########  ######           #     ##
### ### #  ###=  ###### ###### ###########  #####*#########*#*######
###       #############                   *                       ##
####################################################################
####################################################################
