####################################################################
####################################################################
################################################################~###
###D ##############~                       ############    ~      ##
####*#####           ###### ########### ## ############ ##  #*##~ ##
#### ##### ########~ ###### #         # ## ############  q# #   # ##
####  #### ######### ###### # # ### # # ## ###~###########   # C# ##
#####  ##  ######### ###### # # #q# # # ## #W                 ### ##
######    ########## ###### # #     # # ## ###~###########      e ##
#################### ###### #*#######*# ##           ######  #### ##
#################### ######             #######*#### #####  ##### ##
#################### #######~##~####~##~####### #### ####  ###### ##
####################     ###################### ####   #  ####### ##
######################## ###################### #### #  #e####### ##
######################## ###########            #### ##   ####### ##
######################## ########### ############### ############ ##
######################## ##~######## ###############              ##
######################~# #           ##          ### ###############
#####################E   # ~##### ##### ####G### ###          ######
######################~# #>###### ##### ######## #####*###### ######
######################## ######## ##### ######## #####      # ######
#####       #       #### ######## ##### ######## ##### # #### ######
##### ##### # ##### #### ####     #####          ##### # #    ######
##### #   # # #   # #### #### ### ###### ###### ##   # # # #########
##### # # # # # # # #### #### #X# ###### #    # #  # # # # #########
##### # # # # # # # #### #### # # ###### ## # # ## #     # #########
##### # # # # # # # ####      # #        #  # #  # # ### # #########
##### # # # # # # # #########d# #d##### ## ## ## # #   # # ~### ####
####~ ~ # # # # # # #####     # #     # #     ## # ### # #  *    Q##
###J* # # #   # # # ##### #####*##### # ## ## ## #     # #~ ~## ####
####### # ##### # # #####     * *     # ## #  ## ##### #  # ########
###               # ##### #####*##### # ## # ###     # #  # ########
### #### ### ###### #####     # #     # #      ##### # ## # ########
### #### ### #      ######### # # ##### # ### ###### #    # ########
### #### ### ######     ####p # # ##### # ### ######*##*### ########
### #### ### ########## ##### # # #####                     ########
### #    ###          #     d # #  d ############*# ################
### #   ####### ### # ## #####~ ~### #            # ################
### # # ####### # # #         # #    # ##### ######*################
###   # ####### # # ######### # # #### #  ># ####             ######
####### #     # # #     #     # #   *  # ##~ ~### # # # # # # ######
###     # #~*~# # # ### # ##### ##### #~ ~#   ###             ######
######  #  #I## # # ###       # #     #  ###H#### # # # # # ########
###     ## #### # # ### # ### # # ###*# #########             * ####
##~ ~## ##      # # ###     # # # #   # ######### # # # # # ###  ~##
###*### ######### # ######### # # # ### #########              #  ##
###A###             #########     #p###           # # # # # #  ~~B##
####################################################################
####################################################################
