####################################################################
####################################################################
####################################################################
###+######~       *  # # ####                                     ##
### #     * ######~  * * #### ################################### ##
###a# ####~ ##    * #### ## # # #   #  ############### #   #    $ ##
### *     * #  #### #  # ## # # *   *  #   ########### # # # # ## ##
###*######~ ##   #  ##*#*##*# # #####  *   #X######### # # # #  # ##
###       * #  #### #       # # #   #  #  ~   ~      # # # # # ## ##
#####*####~ ##    * ######### # *   *  ###     ##### ~ # # # #  ~ ##
###     # #  #*###~##     # # # #####  ##### ###   # *   #   # ## ##
######### ####      * ### # # # #   #  ~#### ###   * ~   #   #  # ##
### *          ###### # # # # # #   #  * C## ####### # ######## # ##
### ###########~   ~# # # # # # *   *  ~#### #     * # # ~    # $ ##
### *          *   n# # # * # # #   #######  ####### # #    ~B# # ##
### ###########~   ~# #*### # # ###*#        #     * ~   ###### # ##
### # *        ######*#   * # # #   # ############## * # #      # ##
### # ########          ### # # *   # # #  * * *     ~ #   # #  # ##
### # *      ############## # # #   #    # # # # ########  #####~ ##
### # ####*# #            # # # ########+# #####  #   #   ##    # ##
### # # #  # # ########## # # #      * ~## #   #*##*#   #  # # ## ##
### # # #  # # #        # # # ######## *   # # #  # # #### #*# ## ##
### * # #### # # ###### # # ~ #        ~#### # #    #  #D*   # ## ##
#######      # # #####~ # #   ##*#####   #   #*#######*###*###  $ ##
###   # ###  # # ###J * # # ~ ## #   ###     #           *      # ##
### # #  #   # # ~####~## # # ## # #   #  ################# # # # ##
### #I###### # #          # # ## # ### #  #            * ## # # # ##
###*### ## #*# ##~######### # ## # # # ##*# ############ ## # # # ##
###          #            * # ## # # #    # # *        # ## # # ~ ##
#####*# ## # ######~####### # ## # # ### ## # ########## ## # # # ##
###   ######           ~  * # ## # #   # ## # #        * ##*#*#*# ##
#####*# * #  ##### ~     #### ## # # ### ## # ~######### ##     # ##
### # * # *     #######~ #  # ## # # #    # # *       A# #### ### ##
### ###########  #     # ## # ## #*# ####*# # ~######### #{ $   $ ##
### #        ### #####*# ## # #    #      # #          * #### # # ##
###   # # #    # #     * ## # #*## #  #####*###################*# ##
####*######*## ### ##### #  # #  # *  #         # *      #      # ##
###       #  # #       # # ## #  ###~ # ####### # ###    # ###### ##
###       *  # ### ### # # ## #  #  * # #  #  # #   ###~ *      ~ ##
####*######  # # # # # # # ## ##### ~## #  #  # ### #G * #####  # ##
#### ~{~  #  * #*#*#*#*#*#*## #     #   *     #   # ###~ * #   ## ##
#### # #  #####             # # ### #   # ### *   #    * #   #  # ##
#### # #     *  ###########*# # #H# ### # #W~ #*######## ##### ## ##
#### #*~#######*#         * # # ~*~   # # # * #        # #   #  $ ##
#### ~          # ######### # #     # # ####### ## ### # * #   ## ##
####*###########~*~ # # # # # ######### * * * *        ########## ##
###                       * #         * # # # # ##  ##            ##
####################################################################
####################################################################
