####################################################################
####################################################################
####################################################################
#### ~###                              *    #      # *       #    ##
###   W#    #####  ###########*##########        ###m#  #    #    ##
#### ~###  ##      #         # #      * #   ###    ########       ##
#### # #    #     ########## # ########   ###   ####   # #   #    ##
####b# ## ####### #+ #    ## # #    * #     #          #     ## ####
#### #     # *    #      # # # ###### #   ###########  #     #    ##
####   #   # #### # # %~   # # #  * #     #    # #= ##     ###### ##
#####*###### #  # ##       # # ####     # #      ##$# #    #      ##
###          #    # % # ~%~#*###  #  # #######   #  #  #   # #### ##
#########*#### #### ~      #      #  #  #   #       ##  #  # #    ##
###          # #  ########*# ####   ### ##  #  #    #    ###### ####
###    ## ## # #                #    #  #      ###  ## #     #    ##
#####  #  #  #      #     #     ########## #   # *  #  ##### ## ####
### ## ######### ###### # #  #### # #   #  # ######### #     #    ##
#####  #    #  # #   #  ####  # # #   # #         # #  # # # ## # ##
###    #    ##*# #   *  # *         ###### ##  #  #    ##### #  # ##
###########      ######## # ###    ##  #   #   #  ###### #      # ##
###              #  #     # #    #  ##*##  #  #####  #   ###  #*#*##
### #     # # #  #  ###   #####  ##       ##    # #  #   # ## #   ##
### ##### # # #         # #      #                   # #   #  #   ##
### #   # # # ### #####*########*######*########    #####  # ##*#*##
### #   * # # #    #      #         #     #### ####  #  #    #    ##
######### # # #    #      #  #     ###    #I # #        ###  #    ##
####      # # #    #####     #      #     #~ # #  # #   #    *    ##
####   #  # # ## # # #          # #            # ##*##    ##########
####   #  # # #  # #       #    ~ ~    #       #  # #  ####  #    ##
###    #  # # #  # #     ####  ##B##  ##~#  #  # ##*## #  *  *    ##
###*####### # #  # *  #    A#   ###   #C   ### *  # #  #  ####### ##
### #     # # # ####  #  ####         ##~#     #       *  *     # ##
### #     ~%~%~    ####    #           #       ############## ### ##
### #     # # ######            ###        ### ############## #   ##
### #####*# # #    *   ~ ~     ##D###        # *            # ###*##
###       # # # #  # # #H#   #  ~ ~E# #    #   ############ # #   ##
####*##   # # # ## # #K####  #  # # # #    #   #   #+  * #  # #   ##
###   ### # # # #  # ## #                 #### #   ##### #  #*###*##
###   #   # # ###### #  #      #          #    ### # # # #    #   ##
####*## ### # #    #           ##      ####    *         # ###### ##
###   # # # # #    #      ~ ~  #  ~ ~     #    #   # # # #  #   * ##
###   * # # # #    * ##   #F#  #  #J##    ###~ ####### # #  ##### ##
###   # # # # #### # #    ###  #  ###     #X a # #  #  #    #   * ##
#######   # # #    ####*########*######*#####~##    #  # ######## ##
###  #    #     #     #             ##     #  #     #### #      * ##
###  $    #### ###   ## ##### #     #    #       #     * # ###### ##
###=*# #     *  #  #  # #   ##### #### # #### ##### #### # #n   * ##
####################################################################
####################################################################
