####################################################################
####################################################################
####################################################################
########  #   #          *   #   #                                ##
####  X##*##*######*######## #*### ######*######   ###### #~ ~### ##
#### ###          # #    # # #   * #    # #     # #     # ##I##+# ##
###~*~##*######*#*# #*## # # #*### # #  # ###   # #   ### ####  ####
###           ~ # # #  ### # #   # # ## #   ### # # ###   #       ##
#########  #~*# # #*##*# # # ##### # #  # #  #       #  # ###~*~~###
###     ##*#H #     #    * # *     # #  #  #   ~ ~ ~   #  #     * ##
####### #  #### ### ###### # ##### #### ## ###       ### ###  ##~ ##
###   # *  #    # #    #         *      ##     ~ n ~     ####=### ##
###   #*#### ####*####*##### ########## ## ###       ### ######## ##
### ###  # *  *      #     # #      * # #  #   ~ ~ ~   #  #       ##
### # *  * # ####  #   # #*# #####*## # # #  #       #  # #$###*#*##
###*######## #  ## ## #### #     #  # # #    ## # # ##    #   # # ##
###        * *     #   # # ##### #### # ## ###  # #  ### ##*# # # ##
###*######## ##### ## ##    *  # #    #  # #    # #    # #  # # # ##
### #      #     # #   # #  ##      # ## # #   #   #   # #  # # # ##
### # #### #####*##### #### ###   # #  # # ####     #### #  # # # ##
### # #  #         * # # #  # ##*#####*#*# *    #*#    * ####*# # ##
### #$# ## #####*# # * #   ##     #        ###### ######      # # ##
### # # #        # # ##################### #         #J#*###########
### #=# # ###### # # #                   # ###*## ##*~ ~ #        ##
### ### # #    * # # # ################# # # #  # #      # ###*##*##
###  *  # #   #### # # # *           # # # # # ## ##*##### #    # ##
######### #####    # # # # ##~###~## # # # # #  # #  #     #    # ##
###             #### # # # #       # # # # #   ## ## *  ####    # ##
###*#~######### #  * * # # # ~ W ~ # # # * ######*##### ######### ##
###    #  *  #  # ## # # ~ ~ ##### ~ ~ # ###          # #   #  ## ##
### #~*####     # #  # # # *       * # # #   ###*#### # *   *   * ##
### #  # #  # # # #  # # ############# # ###  #     # # #   #  ##*##
### ##*#*#*##*### #### #               # # # #####*## * ######### ##
### #G #          *  # ######## ######## # * ##     ###*##  ##### ##
### #####  ##*###*## #        ~b~        # #######*##    #  ##+ $ ##
#####   *   # # # #  ########     ######## #  #  #  #    * ###### ##
############# # # #######   #     # * #  #   ###   ####*##    * # ##
###                     ###*###*### # ##   #  #       #  ###### # ##
######*##########*#####             #     ### ###*###*#  #    * # ##
###                   #  ######*#########   # #    #  #  # #### # ##
###  ##~*~#*####*##   #*##             #   ## ######*##### #    #*##
##~  ~A  #     #  ##### ## #####*##### ###  #  #   #       *      ##
###a#######*####~B~ # # #### # # # # #  ######       ###*#####*#*###
### ##           ##*#   * #    # #    #    # #*##*##*# # #   # # ###
### #  # #*##*### #    ##~#*#  # #  #*#~## #    # #    # # ### # ###
### #*#### #  # #  #*# #    ##     ##   D#*###### ###### ### * # ###
###o# #    ## #      # #C~##### # #####~##      *      *     #    ##
####################################################################
####################################################################
